DISEASE,CN,MCI,AD,NaN,TOTAL
Hypertension,309,374,355,11,1049
Arthritis,299,320,275,10,904
Hypercholesterolemia,209,232,240,8,689
Depression,138,236,251,6,631
Thyroid,165,178,156,3,502
Hyperlipidemia,142,181,168,4,495
Hearing,132,181,165,2,480
Osteoarthritis,167,156,137,4,464
Cancer,124,177,152,4,457
Anxiety,57,102,87,1,247
Sleep Apnea,44,113,87,1,245
Insomnia,79,87,50,2,218
